2 2 2 2 2 2 2 2 2 2 2 2 2 2 2 2 2 2 2 2 16 2 2 2 2 16 2 2 23 19 30 31 24 2 16 8 3 3 7 2 2 2 2 2 2 2 2 2 2 2 2 2 2 2 2 2 2 2 2 2 2 2 2 2 2 2 2 2 2 2 2 2 2 2 2 2 2 2 2 2 2 2 2 2 2 2 2 2 2 2 2 2 2 2 2 2 2 2 2 2 
2 16 2 2 2 2 16 2 20 21 21 21 21 21 21 21 21 21 22 2 2 2 2 2 2 2 2 2 23 19 19 19 24 2 2 8 3 3 7 2 2 2 2 2 2 2 2 2 2 2 2 2 2 2 2 16 2 2 2 2 2 2 2 2 2 2 2 2 2 2 2 2 2 2 2 2 2 2 2 2 2 2 2 2 2 2 2 2 2 2 2 2 2 2 2 2 2 2 2 2 
2 2 2 2 2 2 2 2 23 19 18 18 19 18 18 19 19 18 24 2 2 2 2 2 12 10 10 13 25 26 26 26 27 33 2 8 3 3 9 10 10 10 10 10 10 10 10 10 13 2 2 2 2 2 2 2 2 2 2 2 2 2 2 2 2 2 2 2 2 2 2 2 2 2 2 2 2 2 2 2 2 2 2 2 2 2 2 2 2 2 2 2 2 2 2 2 2 2 2 2 
2 2 2 33 2 2 2 2 23 19 18 18 18 28 29 18 19 18 24 2 2 2 2 16 8 3 3 7 2 34 34 34 2 2 2 8 3 3 3 3 3 3 3 3 3 3 3 3 7 2 2 2 2 2 2 2 2 2 2 2 2 2 2 2 2 2 2 2 2 2 2 2 2 2 2 2 2 2 2 2 2 2 2 2 2 2 2 2 2 2 2 2 2 2 2 2 2 2 2 2 
2 2 2 2 2 2 2 2 23 19 19 18 18 30 31 18 18 18 24 2 2 2 2 2 8 3 3 7 33 2 34 34 34 2 16 8 3 3 3 3 3 3 3 3 3 3 3 3 7 2 2 12 10 10 13 2 2 2 16 2 2 2 2 2 2 2 2 2 2 2 2 2 2 2 2 2 2 2 2 2 2 2 2 2 2 2 2 2 2 2 2 2 2 2 2 2 2 2 2 2 
2 2 2 2 2 16 2 2 23 18 18 18 19 19 19 19 18 18 24 2 2 2 2 2 8 3 3 9 10 10 10 10 10 10 10 11 3 3 4 5 5 5 5 5 5 6 3 3 7 2 2 8 3 3 7 2 2 2 2 2 2 2 2 2 2 2 2 2 2 2 2 2 2 2 2 2 2 2 2 2 2 2 2 2 2 2 2 2 2 2 2 2 2 2 2 2 2 2 2 2 
2 16 2 2 2 2 2 2 25 26 26 26 26 26 26 26 26 26 27 2 2 2 2 2 8 3 3 3 3 3 3 3 3 3 3 3 3 3 7 2 2 2 2 2 2 8 3 3 7 34 34 8 3 3 7 2 2 2 2 2 2 2 2 2 2 2 2 2 2 2 2 2 2 2 2 2 2 2 2 2 2 2 2 2 2 2 2 2 2 2 2 2 2 2 2 2 2 2 2 2 
2 2 2 2 33 2 2 2 2 2 2 16 2 2 2 2 16 2 2 2 2 16 2 2 8 3 3 3 3 3 3 3 3 3 3 3 3 3 7 2 2 2 2 2 2 8 3 3 9 10 10 11 3 3 7 2 16 2 2 2 2 2 2 2 2 2 2 2 2 2 2 2 2 2 2 2 2 2 2 2 2 2 2 2 2 2 2 2 2 2 2 2 2 2 2 2 2 2 2 2 
2 2 2 2 2 34 34 34 34 2 2 2 2 2 2 2 2 2 2 2 2 2 2 2 14 5 5 5 5 5 5 5 5 5 5 6 3 3 7 2 2 2 2 2 2 8 3 3 3 3 3 3 3 3 7 2 2 2 2 2 2 2 2 2 2 2 2 2 2 2 2 2 2 2 2 2 2 2 2 2 2 2 2 2 2 2 2 2 2 2 2 2 2 2 2 2 2 2 2 2 
21 22 2 12 10 10 10 10 10 10 13 2 2 2 33 2 2 16 2 2 2 2 2 2 2 2 2 2 2 2 2 2 2 2 2 8 3 3 7 2 2 2 2 2 2 8 3 3 3 3 3 3 3 3 7 2 2 2 2 2 2 2 2 2 2 2 2 2 2 2 2 2 2 2 2 2 2 2 2 2 2 2 2 2 2 2 2 2 2 2 2 2 2 2 2 2 2 2 2 2 
18 24 1 8 3 3 3 3 3 3 7 2 2 2 2 2 2 2 2 2 2 2 2 2 2 2 2 2 2 2 2 2 2 2 2 8 3 3 7 2 2 2 2 2 2 14 5 5 5 5 5 5 5 5 15 2 2 2 2 2 2 2 2 2 2 2 2 2 2 2 2 2 2 2 2 2 2 2 2 2 2 2 2 2 2 2 2 2 2 2 2 2 2 2 2 2 2 2 2 2 
18 24 1 8 3 3 3 3 3 3 7 2 33 2 2 16 2 33 2 2 12 10 10 10 10 10 10 10 10 10 13 2 2 2 2 8 3 3 7 2 2 2 2 2 2 2 2 2 2 2 2 2 2 2 2 2 2 2 2 2 2 2 2 2 2 2 2 2 2 2 12 10 10 13 2 2 2 2 2 2 2 2 2 2 2 2 2 2 2 2 2 2 2 2 2 2 2 2 2 2 
18 24 1 14 5 5 5 6 3 3 9 10 10 10 10 10 10 13 2 2 8 3 3 3 3 3 3 3 3 3 7 2 2 2 2 8 3 3 7 2 2 2 2 12 10 10 10 10 10 10 10 10 10 10 10 10 10 10 13 2 2 2 2 2 2 2 2 2 2 2 8 3 3 7 2 2 2 2 2 2 2 2 2 2 2 2 2 2 2 2 2 2 2 2 2 2 2 2 2 2 
18 24 1 1 34 34 34 8 3 3 3 3 3 3 3 3 3 7 2 2 8 3 3 3 3 3 3 3 3 3 7 2 2 2 2 8 3 3 7 2 2 2 2 8 3 3 3 3 3 3 3 3 3 3 3 3 3 3 7 2 2 2 2 2 2 2 2 2 2 2 8 3 3 7 2 2 2 2 2 2 2 2 2 2 2 2 2 2 2 2 2 2 2 2 2 2 2 2 2 2 
18 24 1 1 34 34 34 8 3 3 3 3 3 3 3 3 3 7 2 2 14 5 5 5 5 5 5 6 3 3 7 2 2 2 2 8 3 3 7 2 2 2 2 8 3 3 3 3 3 3 3 3 3 3 3 3 3 3 7 2 2 2 2 2 2 2 2 2 2 2 8 3 3 7 2 2 2 2 2 2 2 2 2 2 2 2 2 2 2 2 2 2 2 2 2 2 2 2 2 2 
18 24 1 12 10 10 10 11 3 3 4 5 5 5 6 3 3 7 2 2 2 2 2 2 2 2 2 8 3 3 7 2 2 2 2 8 3 3 7 2 2 2 2 8 3 3 4 5 5 5 5 5 5 5 5 6 3 3 7 2 2 2 2 2 2 2 2 2 2 2 8 3 3 7 2 2 2 2 2 2 2 2 2 2 2 2 2 2 2 2 2 2 2 2 2 2 2 2 2 2 
18 24 1 8 3 3 3 3 3 3 7 16 2 2 8 3 3 7 12 10 10 10 10 10 10 13 2 8 3 3 7 2 2 2 2 8 3 3 7 2 2 2 2 8 3 3 7 2 2 2 2 2 2 2 2 8 3 3 7 2 2 12 10 10 10 10 10 10 10 10 11 3 3 7 2 2 2 2 2 2 2 2 2 2 2 2 2 2 2 2 2 2 2 2 2 2 2 2 2 2 
18 24 2 8 3 3 3 3 3 3 7 2 2 33 8 3 3 7 8 3 3 3 3 3 3 7 2 8 3 3 9 10 10 10 10 11 3 3 9 10 10 10 10 11 3 3 9 10 10 10 10 13 2 2 2 8 3 3 7 2 2 8 3 3 3 3 3 3 3 3 3 3 3 7 2 2 2 2 2 2 2 2 2 2 2 2 2 2 2 2 2 2 2 2 2 2 2 2 2 2 
18 24 2 14 5 5 5 5 5 5 15 2 2 16 8 3 3 7 8 3 3 3 3 3 3 7 2 8 3 3 3 3 3 3 3 3 3 3 3 3 3 3 3 3 3 3 3 3 3 3 3 7 2 2 2 8 3 3 7 2 2 8 3 3 3 3 3 3 3 3 3 3 3 7 2 2 2 2 2 2 2 2 2 2 2 2 2 2 2 2 2 2 2 2 2 2 2 2 2 2 
18 24 2 2 34 34 34 34 34 2 2 33 2 2 8 3 3 7 14 5 5 5 6 3 3 7 2 8 3 3 3 3 3 3 3 3 3 3 3 3 3 3 3 3 3 3 3 3 3 3 3 7 2 2 2 8 3 3 7 2 2 8 3 3 4 5 5 5 5 5 5 5 5 15 2 2 2 2 2 2 2 2 2 2 2 2 2 2 2 2 2 2 2 2 2 2 2 2 2 2 
26 27 2 2 2 2 2 12 10 10 10 10 10 10 11 3 3 9 10 10 10 13 8 3 3 7 2 8 3 3 4 5 5 5 5 5 5 5 5 5 5 5 5 5 5 5 5 5 6 3 3 7 2 2 2 8 3 3 7 2 2 8 3 3 7 2 2 2 2 2 2 2 2 2 2 2 2 2 2 2 2 2 2 2 2 2 2 2 2 2 2 2 2 2 2 2 2 2 2 2 
34 34 2 2 2 2 2 8 3 3 3 3 3 3 3 3 3 3 3 3 3 7 8 3 3 7 2 8 3 3 7 2 2 2 2 2 2 2 2 2 2 2 2 12 10 10 13 2 8 3 3 7 2 2 2 8 3 3 7 2 2 8 3 3 7 2 2 2 2 2 2 2 2 2 2 2 2 2 2 2 2 2 2 2 2 2 2 2 2 2 2 2 2 2 2 2 2 2 2 2 
32 32 32 32 32 32 2 8 3 3 3 3 3 3 3 3 3 3 3 3 3 7 8 3 3 7 2 8 3 3 7 2 2 2 2 2 2 2 2 2 2 2 2 8 3 3 7 2 8 3 3 7 2 2 2 8 3 3 7 2 2 8 3 3 7 2 2 2 2 2 2 2 2 2 2 2 2 2 2 2 2 2 2 2 2 2 2 2 2 2 2 2 2 2 2 2 2 2 2 2 
17 17 17 17 17 32 16 8 3 3 4 5 5 5 6 3 3 4 5 5 5 15 8 3 3 7 2 8 3 3 7 2 2 2 2 2 2 2 2 2 2 2 2 8 3 3 7 2 8 3 3 9 10 10 10 11 3 3 7 2 2 8 3 3 7 2 2 2 2 2 2 2 2 2 2 2 2 2 2 2 2 2 2 2 2 2 2 2 2 2 2 2 2 2 2 2 2 2 2 2 
17 17 17 17 17 32 2 8 3 3 7 2 2 2 8 3 3 7 34 34 34 34 8 3 3 7 2 8 3 3 7 2 2 12 10 10 10 10 10 10 10 10 10 11 3 3 7 2 8 3 3 3 3 3 3 3 3 3 7 2 2 8 3 3 9 10 10 10 10 10 10 10 10 10 10 10 13 2 2 2 2 2 2 2 2 2 2 2 2 2 2 2 2 2 2 2 2 2 2 2 
17 17 17 17 17 32 2 8 3 3 7 2 16 2 8 3 3 9 10 10 10 10 11 3 3 7 2 8 3 3 7 2 2 8 3 3 3 3 3 3 3 3 3 3 3 3 7 2 8 3 3 3 3 3 3 3 3 3 7 2 2 8 3 3 3 3 3 3 3 3 3 3 3 3 3 3 7 2 2 2 2 2 2 2 2 2 2 2 2 2 2 2 2 2 2 2 2 2 2 2 
17 17 17 17 17 32 2 8 3 3 7 2 2 2 8 3 3 3 3 3 3 3 3 3 3 7 2 8 3 3 7 2 2 8 3 3 3 3 3 3 3 3 3 3 3 3 7 2 8 3 3 4 5 5 5 5 5 5 15 2 2 8 3 3 3 3 3 3 3 3 3 3 3 3 3 3 7 2 2 2 2 2 2 2 2 2 2 2 2 2 2 2 2 2 2 2 2 2 2 2 
17 17 17 17 17 32 2 8 3 3 7 2 2 2 8 3 3 3 3 3 3 3 3 3 3 7 2 8 3 3 7 2 2 8 3 3 4 5 6 3 3 4 5 5 5 5 15 2 8 3 3 7 2 2 2 2 2 2 2 2 2 8 3 3 4 5 5 5 5 6 3 3 4 5 5 5 15 2 2 2 2 2 2 2 2 2 2 2 2 2 2 2 2 2 2 2 2 2 2 2 
17 17 17 17 17 32 2 8 3 3 7 16 2 2 14 5 5 5 5 5 5 5 5 5 5 15 2 8 3 3 7 2 2 8 3 3 7 2 8 3 3 7 2 2 2 2 2 2 8 3 3 7 2 2 2 2 2 2 2 2 2 8 3 3 7 2 2 2 2 8 3 3 7 2 2 2 2 2 2 2 12 10 10 13 2 2 2 2 2 2 2 2 2 2 2 2 2 2 2 2 
17 17 17 17 17 32 2 8 3 3 7 2 2 2 16 2 2 2 2 2 2 2 2 2 2 2 2 8 3 3 7 2 2 8 3 3 7 2 8 3 3 7 2 2 2 2 2 2 8 3 3 7 2 2 2 2 2 2 2 2 2 8 3 3 7 2 2 2 2 8 3 3 7 2 2 2 2 2 2 2 8 3 3 7 2 2 2 2 2 2 2 2 2 2 2 2 2 2 2 2 
17 17 17 17 17 35 2 8 3 3 9 10 10 10 10 10 10 10 10 10 10 10 10 10 10 10 10 11 3 3 9 10 10 11 3 3 7 2 8 3 3 7 2 2 2 2 2 2 8 3 3 7 2 2 2 2 2 2 2 2 2 8 3 3 7 2 2 2 2 8 3 3 7 2 2 2 2 2 2 2 8 3 3 7 2 2 2 2 2 2 2 2 2 2 2 2 2 2 2 2 
17 17 17 17 17 32 16 8 3 3 3 3 3 3 3 3 3 3 3 3 3 3 3 3 3 3 3 3 3 3 3 3 3 3 3 3 7 2 8 3 3 7 2 2 2 2 2 2 8 3 3 9 10 10 10 10 10 10 10 10 10 11 3 3 7 2 2 2 2 8 3 3 7 2 2 2 2 2 2 2 8 3 3 7 2 2 2 2 2 2 2 2 2 2 2 2 2 2 2 2 
17 17 17 17 17 32 2 8 3 3 3 3 3 3 3 3 3 3 3 3 3 3 3 3 3 3 3 3 3 3 3 3 3 3 3 3 7 2 8 3 3 7 2 2 2 2 2 2 8 3 3 3 3 3 3 3 3 3 3 3 3 3 3 3 7 2 2 2 2 8 3 3 7 2 2 2 2 2 2 2 8 3 3 7 2 2 2 2 2 2 2 2 2 2 2 2 2 2 2 2 
32 32 32 32 32 32 2 14 5 5 5 5 5 5 5 5 6 3 3 4 5 5 6 3 3 4 5 5 5 5 5 5 5 5 5 5 2 2 8 3 3 9 10 10 10 13 2 2 8 3 3 3 3 3 3 3 3 3 3 3 3 3 3 3 7 2 2 2 2 8 3 3 7 2 2 2 2 2 2 2 8 3 3 9 10 10 10 13 2 2 2 2 2 2 2 2 2 2 2 2 
2 2 2 2 16 2 2 2 2 2 2 2 33 2 2 2 8 3 3 7 2 2 8 3 3 7 2 2 2 2 2 2 2 2 2 2 2 2 8 3 3 3 3 3 3 7 2 2 14 5 5 5 5 5 5 5 5 5 5 5 5 5 5 5 15 2 2 2 2 8 3 3 3 3 3 3 3 3 3 3 3 3 3 3 3 3 3 7 2 2 2 2 2 2 2 2 2 2 2 2 
2 2 2 2 2 2 2 2 16 2 2 2 2 2 2 2 8 3 3 7 2 2 8 3 3 7 2 2 2 2 2 2 2 2 2 2 2 2 8 3 3 3 3 3 3 7 2 2 2 34 34 34 34 34 34 34 34 2 2 2 2 2 2 2 2 2 2 2 2 8 3 3 3 3 3 3 3 3 3 3 3 3 3 3 3 3 3 7 2 2 2 2 2 2 2 2 2 2 2 2 
2 16 2 2 2 2 2 2 2 2 2 2 2 2 2 33 8 3 3 7 2 2 8 3 3 7 2 12 10 10 13 2 2 2 2 2 2 2 14 5 5 5 5 5 5 15 2 2 2 2 2 2 2 2 2 2 34 2 2 2 2 2 2 2 2 2 2 2 2 8 3 3 4 5 5 5 5 5 5 6 3 3 4 5 5 5 5 15 2 2 2 2 2 2 2 2 2 2 2 2 
2 2 2 2 2 33 2 2 2 2 2 33 2 2 2 2 8 3 3 7 2 2 8 3 3 7 2 8 3 3 7 2 12 10 10 10 10 10 10 13 2 2 20 21 21 21 21 21 21 21 21 21 21 21 22 2 34 2 2 2 2 2 2 2 2 2 2 2 2 8 3 3 7 2 2 2 2 2 2 8 3 3 7 2 2 2 2 2 2 2 2 2 2 2 2 2 2 2 2 2 
2 2 2 2 2 2 2 2 2 2 12 10 10 13 2 2 8 3 3 7 2 2 8 3 3 9 10 11 3 3 7 2 8 3 3 3 3 3 3 7 2 2 23 19 18 18 18 18 18 18 18 18 19 18 24 2 34 2 2 2 2 2 2 2 2 2 2 2 2 8 3 3 7 2 2 2 2 2 2 8 3 3 7 2 2 2 2 2 2 2 2 2 2 2 2 2 2 2 2 2 
2 2 2 2 2 2 2 2 2 2 8 3 3 7 2 2 14 5 5 15 2 2 8 3 3 3 3 3 3 3 7 2 8 3 3 3 3 3 3 7 2 2 23 18 19 19 19 19 18 18 18 18 18 18 24 2 34 12 10 10 10 10 10 10 10 13 2 2 2 8 3 3 7 2 2 2 2 2 2 8 3 3 7 2 2 2 2 2 2 2 2 2 2 2 2 2 2 2 2 2 
2 2 2 2 2 2 2 2 2 2 8 3 3 7 2 2 2 2 2 2 2 2 8 3 3 3 3 3 3 3 7 2 8 3 3 4 5 5 5 15 2 2 23 18 18 18 18 18 19 19 18 18 18 18 24 2 34 8 3 3 3 3 3 3 3 7 2 2 2 8 3 3 9 10 10 10 13 2 2 8 3 3 7 2 2 2 2 2 2 2 2 2 2 2 2 2 2 2 2 2 
32 32 32 32 32 32 32 32 32 2 8 3 3 7 2 2 2 2 2 2 2 2 14 5 5 5 5 5 5 5 15 2 8 3 3 7 2 2 2 2 2 2 23 18 18 18 18 18 18 18 19 19 19 18 24 2 2 8 3 3 3 3 3 3 3 7 2 2 2 8 3 3 3 3 3 3 7 2 2 8 3 3 9 10 10 10 10 10 10 10 10 10 10 10 13 2 2 2 2 2 
21 21 21 21 21 21 21 22 32 2 8 3 3 9 10 10 10 10 10 10 10 10 10 10 10 10 10 10 10 10 10 10 11 3 3 7 2 2 2 2 2 2 23 18 18 19 18 18 19 18 18 18 19 19 24 2 2 14 5 5 5 5 6 3 3 7 2 2 2 8 3 3 3 3 3 3 7 2 2 8 3 3 3 3 3 3 3 3 3 3 3 3 3 3 7 2 2 2 2 2 
18 18 18 18 18 18 18 24 32 2 8 3 3 3 3 3 3 3 3 3 3 3 3 3 3 3 3 3 3 3 3 3 3 3 3 7 2 2 2 2 2 2 23 18 18 18 18 19 19 18 18 19 19 18 24 2 2 2 2 2 2 2 8 3 3 7 2 2 2 14 5 5 5 5 5 5 15 2 2 8 3 3 3 3 3 3 3 3 3 3 3 3 3 3 7 2 2 2 2 2 
18 18 18 18 18 18 18 24 2 2 8 3 3 3 3 3 3 3 3 3 3 3 3 3 3 3 3 3 3 3 3 3 3 3 3 7 2 2 2 2 2 2 25 26 26 26 26 26 26 26 26 26 26 26 27 2 2 2 2 2 2 2 8 3 3 7 2 2 2 2 2 2 2 2 2 2 2 2 2 14 5 5 5 5 5 5 5 5 5 5 5 6 3 3 7 2 2 2 2 2 
18 18 18 18 18 18 18 24 2 2 14 5 5 5 5 5 5 5 5 5 5 5 5 5 6 3 3 4 5 5 5 5 5 5 5 15 2 2 2 2 2 2 2 2 2 2 2 2 2 2 2 2 2 2 2 2 2 2 2 2 2 2 8 3 3 7 2 2 2 2 2 2 2 2 2 2 2 2 2 2 2 2 2 2 2 2 2 2 2 2 2 8 3 3 7 2 2 2 2 2 
18 18 18 18 18 18 18 24 2 2 2 2 2 2 2 2 2 2 2 2 2 2 2 2 8 3 3 7 2 2 2 2 2 2 2 2 2 2 2 2 2 12 10 10 10 10 10 10 10 10 10 10 10 10 13 2 2 2 2 2 2 2 8 3 3 9 10 10 10 10 13 2 2 2 2 2 2 2 2 2 2 2 2 2 2 2 2 2 2 2 2 8 3 3 7 2 2 2 2 2 
18 18 18 18 18 18 18 24 32 2 2 2 2 2 2 2 2 2 2 2 2 2 2 2 8 3 3 7 2 2 2 2 2 2 2 2 2 2 2 2 2 8 3 3 3 3 3 3 3 3 3 3 3 3 7 2 2 2 2 2 2 2 8 3 3 3 3 3 3 3 7 2 2 2 2 2 2 2 2 2 2 2 2 2 2 2 2 2 2 2 2 8 3 3 7 2 2 2 2 2 
26 26 26 26 26 26 26 27 32 2 2 12 10 10 10 10 10 10 10 10 10 10 10 10 11 3 3 7 2 2 12 10 10 10 10 10 10 13 2 2 2 8 3 3 3 3 3 3 3 3 3 3 3 3 7 2 2 2 2 2 2 2 8 3 3 3 3 3 3 3 7 2 2 2 2 2 2 2 2 2 2 2 2 2 2 2 2 2 2 2 2 8 3 3 7 2 2 2 2 2 
32 32 32 32 32 32 32 32 32 2 2 8 3 3 3 3 3 3 3 3 3 3 3 3 3 3 3 7 2 2 8 3 3 3 3 3 3 7 2 2 2 8 3 3 4 5 5 5 5 5 5 6 3 3 7 2 2 2 2 2 2 2 14 5 5 5 5 6 3 3 7 2 2 2 2 2 2 2 2 2 2 2 2 2 2 2 2 2 2 2 2 8 3 3 7 2 2 2 2 2 
34 34 34 2 2 2 2 2 2 2 2 8 3 3 3 3 3 3 3 3 3 3 3 3 3 3 3 7 2 2 8 3 3 3 3 3 3 7 2 2 2 8 3 3 7 2 2 2 2 2 2 8 3 3 7 2 2 2 2 2 2 2 2 2 2 2 2 8 3 3 7 2 2 2 2 2 2 12 10 10 10 10 10 10 10 10 10 13 2 2 2 8 3 3 7 2 2 2 2 2 
2 2 2 2 12 10 10 10 10 10 10 11 3 3 4 5 5 5 5 5 5 5 5 5 5 5 5 15 2 2 8 3 3 4 5 5 5 15 2 2 2 8 3 3 7 12 10 10 10 10 13 8 3 3 7 2 2 2 2 2 2 2 2 2 2 2 2 8 3 3 7 2 2 2 2 2 2 8 3 3 3 3 3 3 3 3 3 7 2 2 2 8 3 3 7 2 2 2 2 2 
2 2 2 34 8 3 3 3 3 3 3 3 3 3 7 2 2 2 2 2 2 2 2 2 2 2 2 2 2 2 8 3 3 7 2 2 2 2 2 2 2 8 3 3 7 8 3 3 3 3 7 8 3 3 7 2 2 2 2 2 2 2 2 2 2 2 2 8 3 3 7 2 2 2 2 2 2 8 3 3 3 3 3 3 3 3 3 7 2 2 2 8 3 3 7 2 2 2 2 2 
2 16 2 34 8 3 3 3 3 3 3 3 3 3 7 2 2 2 2 2 2 2 2 2 2 2 2 2 2 2 8 3 3 7 2 2 2 2 2 2 2 8 3 3 7 8 3 3 3 3 7 8 3 3 7 2 2 12 10 10 10 10 10 10 10 10 10 11 3 3 7 2 2 2 2 2 2 8 3 3 4 5 5 5 5 5 5 15 2 2 2 8 3 3 7 2 2 2 2 2 
2 2 2 2 8 3 3 4 5 5 5 6 3 3 9 10 10 10 10 10 10 10 10 10 10 10 10 10 10 10 11 3 3 9 10 10 10 10 13 2 2 8 3 3 7 8 3 3 4 5 15 8 3 3 7 2 2 8 3 3 3 3 3 3 3 3 3 3 3 3 7 2 2 2 2 2 2 8 3 3 7 2 2 2 2 2 2 2 2 2 2 8 3 3 7 2 2 2 2 2 
2 2 2 33 8 3 3 7 33 2 2 8 3 3 3 3 3 3 3 3 3 3 3 3 3 3 3 3 3 3 3 3 3 3 3 3 3 3 7 2 2 8 3 3 7 8 3 3 9 10 10 11 3 3 7 2 2 8 3 3 3 3 3 3 3 3 3 3 3 3 7 2 2 2 2 2 2 8 3 3 7 2 2 2 2 2 2 2 2 2 2 8 3 3 7 2 2 2 2 2 
16 2 2 2 8 3 3 7 2 2 2 8 3 3 3 3 3 3 3 3 3 3 3 3 3 3 3 3 3 3 3 3 3 3 3 3 3 3 7 2 2 8 3 3 7 8 3 3 3 3 3 3 3 3 7 2 2 8 3 3 4 5 5 6 3 3 4 5 5 5 15 2 2 2 2 2 2 8 3 3 7 2 2 2 2 2 2 2 2 2 2 8 3 3 7 2 2 2 2 2 
2 2 2 16 8 3 3 7 2 2 33 14 5 5 5 5 5 5 5 5 6 3 3 4 5 5 5 5 5 5 5 5 5 5 5 5 5 5 15 2 2 8 3 3 7 8 3 3 3 3 3 3 3 3 7 2 2 8 3 3 7 2 2 8 3 3 7 2 2 2 2 2 2 2 2 2 2 8 3 3 9 10 10 10 10 10 10 10 10 10 10 11 3 3 7 2 2 2 2 2 
2 33 2 2 8 3 3 7 2 2 2 2 2 2 33 2 2 2 2 2 8 3 3 7 2 2 2 2 2 2 2 2 2 2 2 2 2 2 2 2 2 8 3 3 7 14 5 5 5 5 5 5 5 5 15 2 2 8 3 3 7 2 2 8 3 3 7 2 2 2 2 2 2 2 2 2 2 8 3 3 3 3 3 3 3 3 3 3 3 3 3 3 3 3 7 2 2 2 2 2 
2 2 2 2 8 3 3 7 33 2 2 2 2 2 2 2 2 33 2 2 8 3 3 7 2 2 2 2 2 2 2 2 2 2 2 2 2 2 2 2 2 8 3 3 7 2 2 2 2 2 2 2 2 2 2 2 2 8 3 3 7 2 2 8 3 3 7 2 2 2 2 2 2 2 2 2 2 8 3 3 3 3 3 3 3 3 3 3 3 3 3 3 3 3 7 2 2 2 2 2 
2 2 16 2 8 3 3 7 2 2 2 33 2 2 2 2 2 2 2 2 8 3 3 7 2 2 2 2 2 2 2 2 2 2 2 2 2 2 2 2 2 8 3 3 7 2 2 34 34 34 34 34 34 34 34 34 2 8 3 3 7 2 2 8 3 3 7 2 2 2 2 2 2 2 2 2 2 8 3 3 4 5 5 5 5 5 5 5 5 5 5 5 5 5 15 2 2 2 2 2 
10 10 10 10 11 3 3 7 2 12 10 10 10 10 10 10 13 2 16 2 8 3 3 7 2 2 2 2 2 2 2 2 2 2 2 2 2 2 2 2 2 8 3 3 7 2 34 34 17 17 17 17 17 17 17 34 34 8 3 3 7 2 2 8 3 3 9 10 10 10 10 10 10 10 10 10 10 11 3 3 7 2 2 2 2 2 2 2 2 2 2 2 2 2 2 2 2 2 2 2 
3 3 3 3 3 3 3 7 2 8 3 3 3 3 3 3 7 2 2 2 8 3 3 9 10 10 10 10 10 10 10 10 10 10 10 10 10 10 10 10 10 11 3 3 7 2 34 17 17 17 17 17 17 17 17 17 34 8 3 3 7 2 2 8 3 3 3 3 3 3 3 3 3 3 3 3 3 3 3 3 7 2 2 2 2 2 2 2 2 2 2 2 2 2 2 2 2 2 2 2 
3 3 3 3 3 3 3 7 2 8 3 3 3 3 3 3 7 2 2 2 8 3 3 3 3 3 3 3 3 3 3 3 3 3 3 3 3 3 3 3 3 3 3 3 7 2 34 17 17 17 17 17 17 17 17 17 34 8 3 3 7 2 2 8 3 3 3 3 3 3 3 3 3 3 3 3 3 3 3 3 7 2 2 2 2 2 2 2 2 2 2 2 2 2 2 2 2 2 2 2 
5 5 5 5 6 3 3 7 2 8 3 3 4 5 5 5 15 16 2 2 8 3 3 3 3 3 3 3 3 3 3 3 3 3 3 3 3 3 3 3 3 3 3 3 7 2 34 17 17 17 17 17 17 17 17 17 34 8 3 3 7 2 2 8 3 3 4 5 5 5 5 5 5 5 5 5 5 5 5 5 15 2 2 2 2 2 2 2 2 2 2 2 2 2 2 2 2 2 2 2 
2 2 2 2 8 3 3 7 2 8 3 3 7 2 2 2 2 2 2 2 14 5 5 5 5 5 5 5 5 5 5 5 5 5 5 5 6 3 3 4 5 5 5 5 15 2 34 34 17 17 17 17 17 17 17 34 34 8 3 3 7 2 2 8 3 3 7 2 2 2 2 2 2 2 2 2 2 2 2 2 2 2 2 2 2 2 2 2 2 2 2 2 2 2 2 2 2 2 2 2 
2 2 2 2 8 3 3 9 10 11 3 3 7 2 16 2 2 2 2 16 2 2 2 2 2 2 2 2 2 2 2 2 2 2 2 2 8 3 3 7 2 2 2 2 2 2 2 34 34 34 34 34 34 34 34 34 2 8 3 3 7 2 2 8 3 3 7 2 2 2 2 2 2 2 2 2 2 2 2 2 2 2 2 2 2 2 2 2 2 2 2 2 2 2 2 2 2 2 2 2 
2 2 2 2 8 3 3 3 3 3 3 3 7 2 2 2 2 2 2 2 2 2 2 2 2 2 2 2 2 2 2 2 2 2 2 2 8 3 3 7 2 2 2 2 2 2 2 2 2 2 2 2 2 2 2 2 2 8 3 3 7 2 2 8 3 3 7 2 2 2 2 2 2 2 2 2 2 2 2 2 2 2 2 2 2 2 2 2 2 2 2 2 2 2 2 2 2 2 2 2 
2 2 2 2 8 3 3 3 3 3 3 3 7 2 2 2 2 2 2 2 2 2 2 2 2 2 2 2 2 2 2 2 2 2 2 2 8 3 3 9 10 10 10 10 10 10 10 10 10 10 10 10 10 10 10 10 10 11 3 3 7 2 2 8 3 3 9 10 10 10 10 10 13 2 2 2 2 2 2 2 2 2 2 2 2 2 2 2 2 2 2 2 2 2 2 2 2 2 2 2 
2 2 2 2 14 5 5 5 5 5 5 5 15 2 2 2 2 2 2 2 2 2 2 2 2 2 2 2 2 2 2 2 2 2 2 2 8 3 3 3 3 3 3 3 3 3 3 3 3 3 3 3 3 3 3 3 3 3 3 3 7 2 2 8 3 3 3 3 3 3 3 3 7 2 2 2 2 2 2 2 2 2 2 2 2 2 2 2 2 2 2 2 2 2 2 2 2 2 2 2 
2 2 2 2 2 2 2 2 2 2 2 2 2 2 2 2 2 2 2 2 2 2 2 2 2 2 2 2 2 2 2 2 2 2 2 2 8 3 3 3 3 3 3 3 3 3 3 3 3 3 3 3 3 3 3 3 3 3 3 3 7 2 2 8 3 3 3 3 3 3 3 3 7 2 2 2 2 2 2 2 2 2 2 2 2 2 2 2 2 2 2 2 2 2 2 2 2 2 2 2 
2 2 2 2 2 2 2 2 2 2 2 2 2 2 2 2 2 2 2 2 2 2 2 2 2 2 2 2 2 2 2 2 2 2 2 2 14 5 5 5 5 5 5 5 5 5 5 5 5 5 5 5 5 5 5 5 5 5 5 5 15 2 2 14 5 5 5 5 5 5 5 5 15 2 2 2 2 2 2 2 2 2 2 2 2 2 2 2 2 2 2 2 2 2 2 2 2 2 2 2 
2 2 2 2 2 2 2 2 2 2 2 2 2 2 2 2 2 2 2 2 2 2 2 2 2 2 2 2 2 2 2 2 2 2 2 2 2 2 2 2 2 2 2 2 2 2 2 2 2 2 2 2 2 2 2 2 2 2 2 2 2 2 2 2 2 2 2 2 2 2 2 2 2 2 2 2 2 2 2 2 2 2 2 2 2 2 2 2 2 2 2 2 2 2 2 2 2 2 2 2 
2 2 2 2 2 2 2 2 2 2 2 2 2 2 2 2 2 2 2 2 2 2 2 2 2 2 2 2 2 2 2 2 2 2 2 2 2 2 2 2 2 2 2 2 2 2 2 2 2 2 2 2 2 2 2 2 2 2 2 2 2 2 2 2 2 2 2 2 2 2 2 2 2 2 2 2 2 2 2 2 2 2 2 2 2 2 2 2 2 2 2 2 2 2 2 2 2 2 2 2 
2 2 2 2 2 2 2 2 2 2 2 2 2 2 2 2 2 2 2 2 2 2 2 2 2 2 2 2 2 2 2 2 2 2 2 2 2 2 2 2 2 2 2 2 2 2 2 2 2 2 2 2 2 2 2 2 2 2 2 2 2 2 2 2 2 2 2 2 2 2 2 2 2 2 2 2 2 2 2 2 2 2 2 2 2 2 2 2 2 2 2 2 2 2 2 2 2 2 2 2 
2 2 2 2 2 2 2 2 2 2 2 2 2 2 2 2 2 2 2 2 2 2 2 2 2 2 2 2 2 2 2 2 2 2 2 2 2 2 2 2 2 2 2 2 2 2 2 2 2 2 2 2 2 2 2 2 2 2 2 2 2 2 2 2 2 2 2 2 2 2 2 2 2 2 2 2 2 2 2 2 2 2 2 2 2 2 2 2 2 2 2 2 2 2 2 2 2 2 2 2 
2 2 2 2 2 2 2 2 2 2 2 2 2 2 2 2 2 2 2 2 2 2 2 2 2 2 2 2 2 2 2 2 2 2 2 2 2 2 2 2 2 2 2 2 2 2 2 2 2 2 2 2 2 2 2 2 2 2 2 2 2 2 2 2 2 2 2 2 2 2 2 2 2 2 2 2 2 2 2 2 2 2 2 2 2 2 2 2 2 2 2 2 2 2 2 2 2 2 2 2 
2 2 2 2 2 2 2 2 2 2 2 2 2 2 2 2 2 2 2 2 2 2 2 2 2 2 2 2 2 2 2 2 2 2 2 2 2 2 2 2 2 2 2 2 2 2 2 2 2 2 2 2 2 2 2 2 2 2 2 2 2 2 2 2 2 2 2 2 2 2 2 2 2 2 2 2 2 2 2 2 2 2 2 2 2 2 2 2 2 2 2 2 2 2 2 2 2 2 2 2 
2 2 2 2 2 2 2 2 2 2 2 2 2 2 2 2 2 2 2 2 2 2 2 2 2 2 2 2 2 2 2 2 2 2 2 2 2 2 2 2 2 2 2 2 2 2 2 2 2 2 2 2 2 2 2 2 2 2 2 2 2 2 2 2 2 2 2 2 2 2 2 2 2 2 2 2 2 2 2 2 2 2 2 2 2 2 2 2 2 2 2 2 2 2 2 2 2 2 2 2 
2 2 2 2 2 2 2 2 2 2 2 2 2 2 2 2 2 2 2 2 2 2 2 2 2 2 2 2 2 2 2 2 2 2 2 2 2 2 2 2 2 2 2 2 2 2 2 2 2 2 2 2 2 2 2 2 2 2 2 2 2 2 2 2 2 2 2 2 2 2 2 2 2 2 2 2 2 2 2 2 2 2 2 2 2 2 2 2 2 2 2 2 2 2 2 2 2 2 2 2 
0 0 0 0 0 0 0 0 0 0 0 0 0 0 0 0 0 0 0 0 0 0 0 0 0 0 0 0 0 0 0 0 0 0 0 0 0 0 0 0 0 0 0 0 0 0 0 0 0 0 0 0 0 0 0 0 0 0 0 0 0 0 0 0 0 0 0 0 0 0 0 0 0 0 0 0 0 0 0 0 0 0 0 0 0 0 0 0 0 0 0 0 0 0 0 0 0 0 0 0 
0 0 0 0 0 0 0 0 0 0 0 0 0 0 0 0 0 0 0 0 0 0 0 0 0 0 0 0 0 0 0 0 0 0 0 0 0 0 0 0 0 0 0 0 0 0 0 0 0 0 0 0 0 0 0 0 0 0 0 0 0 0 0 0 0 0 0 0 0 0 0 0 0 0 0 0 0 0 0 0 0 0 0 0 0 0 0 0 0 0 0 0 0 0 0 0 0 0 0 0 
0 0 0 0 0 0 0 0 0 0 0 0 0 0 0 0 0 0 0 0 0 0 0 0 0 0 0 0 0 0 0 0 0 0 0 0 0 0 0 0 0 0 0 0 0 0 0 0 0 0 0 0 0 0 0 0 0 0 0 0 0 0 0 0 0 0 0 0 0 0 0 0 0 0 0 0 0 0 0 0 0 0 0 0 0 0 0 0 0 0 0 0 0 0 0 0 0 0 0 0 
0 0 0 0 0 0 0 0 0 0 0 0 0 0 0 0 0 0 0 0 0 0 0 0 0 0 0 0 0 0 0 0 0 0 0 0 0 0 0 0 0 0 0 0 0 0 0 0 0 0 0 0 0 0 0 0 0 0 0 0 0 0 0 0 0 0 0 0 0 0 0 0 0 0 0 0 0 0 0 0 0 0 0 0 0 0 0 0 0 0 0 0 0 0 0 0 0 0 0 0 
0 0 0 0 0 0 0 0 0 0 0 0 0 0 0 0 0 0 0 0 0 0 0 0 0 0 0 0 0 0 0 0 0 0 0 0 0 0 0 0 0 0 0 0 0 0 0 0 0 0 0 0 0 0 0 0 0 0 0 0 0 0 0 0 0 0 0 0 0 0 0 0 0 0 0 0 0 0 0 0 0 0 0 0 0 0 0 0 0 0 0 0 0 0 0 0 0 0 0 0 
0 0 0 0 0 0 0 0 0 0 0 0 0 0 0 0 0 0 0 0 0 0 0 0 0 0 0 0 0 0 0 0 0 0 0 0 0 0 0 0 0 0 0 0 0 0 0 0 0 0 0 0 0 0 0 0 0 0 0 0 0 0 0 0 0 0 0 0 0 0 0 0 0 0 0 0 0 0 0 0 0 0 0 0 0 0 0 0 0 0 0 0 0 0 0 0 0 0 0 0 
0 0 0 0 0 0 0 0 0 0 0 0 0 0 0 0 0 0 0 0 0 0 0 0 0 0 0 0 0 0 0 0 0 0 0 0 0 0 0 0 0 0 0 0 0 0 0 0 0 0 0 0 0 0 0 0 0 0 0 0 0 0 0 0 0 0 0 0 0 0 0 0 0 0 0 0 0 0 0 0 0 0 0 0 0 0 0 0 0 0 0 0 0 0 0 0 0 0 0 0 
0 0 0 0 0 0 0 0 0 0 0 0 0 0 0 0 0 0 0 0 0 0 0 0 0 0 0 0 0 0 0 0 0 0 0 0 0 0 0 0 0 0 0 0 0 0 0 0 0 0 0 0 0 0 0 0 0 0 0 0 0 0 0 0 0 0 0 0 0 0 0 0 0 0 0 0 0 0 0 0 0 0 0 0 0 0 0 0 0 0 0 0 0 0 0 0 0 0 0 0 
0 0 0 0 0 0 0 0 0 0 0 0 0 0 0 0 0 0 0 0 0 0 0 0 0 0 0 0 0 0 0 0 0 0 0 0 0 0 0 0 0 0 0 0 0 0 0 0 0 0 0 0 0 0 0 0 0 0 0 0 0 0 0 0 0 0 0 0 0 0 0 0 0 0 0 0 0 0 0 0 0 0 0 0 0 0 0 0 0 0 0 0 0 0 0 0 0 0 0 0 
0 0 0 0 0 0 0 0 0 0 0 0 0 0 0 0 0 0 0 0 0 0 0 0 0 0 0 0 0 0 0 0 0 0 0 0 0 0 0 0 0 0 0 0 0 0 0 0 0 0 0 0 0 0 0 0 0 0 0 0 0 0 0 0 0 0 0 0 0 0 0 0 0 0 0 0 0 0 0 0 0 0 0 0 0 0 0 0 0 0 0 0 0 0 0 0 0 0 0 0 
0 0 0 0 0 0 0 0 0 0 0 0 0 0 0 0 0 0 0 0 0 0 0 0 0 0 0 0 0 0 0 0 0 0 0 0 0 0 0 0 0 0 0 0 0 0 0 0 0 0 0 0 0 0 0 0 0 0 0 0 0 0 0 0 0 0 0 0 0 0 0 0 0 0 0 0 0 0 0 0 0 0 0 0 0 0 0 0 0 0 0 0 0 0 0 0 0 0 0 0 
0 0 0 0 0 0 0 0 0 0 0 0 0 0 0 0 0 0 0 0 0 0 0 0 0 0 0 0 0 0 0 0 0 0 0 0 0 0 0 0 0 0 0 0 0 0 0 0 0 0 0 0 0 0 0 0 0 0 0 0 0 0 0 0 0 0 0 0 0 0 0 0 0 0 0 0 0 0 0 0 0 0 0 0 0 0 0 0 0 0 0 0 0 0 0 0 0 0 0 0 
0 0 0 0 0 0 0 0 0 0 0 0 0 0 0 0 0 0 0 0 0 0 0 0 0 0 0 0 0 0 0 0 0 0 0 0 0 0 0 0 0 0 0 0 0 0 0 0 0 0 0 0 0 0 0 0 0 0 0 0 0 0 0 0 0 0 0 0 0 0 0 0 0 0 0 0 0 0 0 0 0 0 0 0 0 0 0 0 0 0 0 0 0 0 0 0 0 0 0 0 
0 0 0 0 0 0 0 0 0 0 0 0 0 0 0 0 0 0 0 0 0 0 0 0 0 0 0 0 0 0 0 0 0 0 0 0 0 0 0 0 0 0 0 0 0 0 0 0 0 0 0 0 0 0 0 0 0 0 0 0 0 0 0 0 0 0 0 0 0 0 0 0 0 0 0 0 0 0 0 0 0 0 0 0 0 0 0 0 0 0 0 0 0 0 0 0 0 0 0 0 
0 0 0 0 0 0 0 0 0 0 0 0 0 0 0 0 0 0 0 0 0 0 0 0 0 0 0 0 0 0 0 0 0 0 0 0 0 0 0 0 0 0 0 0 0 0 0 0 0 0 0 0 0 0 0 0 0 0 0 0 0 0 0 0 0 0 0 0 0 0 0 0 0 0 0 0 0 0 0 0 0 0 0 0 0 0 0 0 0 0 0 0 0 0 0 0 0 0 0 0 
0 0 0 0 0 0 0 0 0 0 0 0 0 0 0 0 0 0 0 0 0 0 0 0 0 0 0 0 0 0 0 0 0 0 0 0 0 0 0 0 0 0 0 0 0 0 0 0 0 0 0 0 0 0 0 0 0 0 0 0 0 0 0 0 0 0 0 0 0 0 0 0 0 0 0 0 0 0 0 0 0 0 0 0 0 0 0 0 0 0 0 0 0 0 0 0 0 0 0 0 
0 0 0 0 0 0 0 0 0 0 0 0 0 0 0 0 0 0 0 0 0 0 0 0 0 0 0 0 0 0 0 0 0 0 0 0 0 0 0 0 0 0 0 0 0 0 0 0 0 0 0 0 0 0 0 0 0 0 0 0 0 0 0 0 0 0 0 0 0 0 0 0 0 0 0 0 0 0 0 0 0 0 0 0 0 0 0 0 0 0 0 0 0 0 0 0 0 0 0 0 
0 0 0 0 0 0 0 0 0 0 0 0 0 0 0 0 0 0 0 0 0 0 0 0 0 0 0 0 0 0 0 0 0 0 0 0 0 0 0 0 0 0 0 0 0 0 0 0 0 0 0 0 0 0 0 0 0 0 0 0 0 0 0 0 0 0 0 0 0 0 0 0 0 0 0 0 0 0 0 0 0 0 0 0 0 0 0 0 0 0 0 0 0 0 0 0 0 0 0 0 
0 0 0 0 0 0 0 0 0 0 0 0 0 0 0 0 0 0 0 0 0 0 0 0 0 0 0 0 0 0 0 0 0 0 0 0 0 0 0 0 0 0 0 0 0 0 0 0 0 0 0 0 0 0 0 0 0 0 0 0 0 0 0 0 0 0 0 0 0 0 0 0 0 0 0 0 0 0 0 0 0 0 0 0 0 0 0 0 0 0 0 0 0 0 0 0 0 0 0 0 
0 0 0 0 0 0 0 0 0 0 0 0 0 0 0 0 0 0 0 0 0 0 0 0 0 0 0 0 0 0 0 0 0 0 0 0 0 0 0 0 0 0 0 0 0 0 0 0 0 0 0 0 0 0 0 0 0 0 0 0 0 0 0 0 0 0 0 0 0 0 0 0 0 0 0 0 0 0 0 0 0 0 0 0 0 0 0 0 0 0 0 0 0 0 0 0 0 0 0 0 
