4 5 5 5 6 3 3 3 3 3 16 16 16 16 16 16 16 16 16 16 16 16 16 16 16 16 33 33 33 33 33 8 3 7 34 34 34 34 34 34 34 34 34 8 3 7 33 34 34 34 
7 32 32 32 8 4 5 5 6 3 9 10 10 10 10 10 10 10 10 10 10 10 10 10 10 13 33 33 33 33 33 8 3 7 34 34 34 1 10 10 10 10 10 11 3 7 33 34 34 34 
7 32 32 32 8 34 16 16 8 3 3 3 3 3 3 3 3 3 3 3 3 3 3 3 3 7 33 33 33 33 33 8 3 7 34 34 34 8 3 3 3 3 3 3 3 7 33 33 33 33 
7 32 32 32 8 34 34 16 8 3 4 5 5 5 5 5 5 5 5 5 5 5 5 6 3 7 33 33 33 33 33 8 3 7 34 34 34 1 5 5 5 5 5 6 3 9 10 10 10 10 
9 10 10 10 11 34 16 16 8 3 7 33 33 1 1 1 33 33 33 33 33 33 33 8 3 9 10 10 10 10 10 11 3 9 10 10 10 10 10 13 16 16 16 8 3 3 3 3 3 3 
16 6 3 4 34 34 33 33 8 3 7 33 33 8 3 7 16 33 16 33 16 33 16 8 3 3 3 3 3 3 3 3 3 3 3 3 3 3 3 7 16 16 16 8 3 4 5 5 5 5 
16 8 3 9 10 10 10 10 11 3 7 33 33 8 3 7 33 33 33 33 33 33 33 8 3 4 5 5 5 5 5 5 5 5 5 5 5 6 3 9 10 10 10 11 3 7 16 16 16 16 
16 8 3 3 3 3 3 3 3 3 7 33 33 8 3 9 10 10 10 10 10 10 10 11 3 7 34 34 34 34 34 34 34 34 16 16 34 8 3 3 3 3 3 3 3 7 16 33 33 33 
1 14 5 5 5 5 5 6 3 3 9 13 33 8 3 3 3 3 3 3 3 3 3 3 3 7 34 1 1 1 1 1 1 1 1 1 34 8 3 4 5 5 5 6 3 7 16 33 33 33 
21 21 21 21 21 21 21 22 6 3 3 7 33 8 3 4 5 5 5 6 3 4 5 5 5 1 34 1 1 1 1 1 1 1 1 1 34 8 3 7 34 34 34 8 3 7 16 16 16 16 
18 18 18 18 18 18 18 30 22 6 3 9 10 11 3 7 16 16 16 8 3 7 1 1 1 1 34 34 34 34 34 34 34 34 34 34 34 8 3 7 34 1 34 8 3 9 10 10 10 10 
18 18 18 18 18 18 18 18 24 8 3 3 3 3 3 7 1 1 16 8 3 9 10 10 10 10 10 10 10 10 10 10 10 10 10 10 10 11 3 7 34 1 34 8 3 3 3 3 3 3 
29 18 18 18 18 18 18 18 27 14 5 5 5 5 5 1 1 1 16 8 3 3 3 3 3 3 3 3 3 3 3 3 3 3 3 3 3 3 3 7 34 1 34 8 3 4 5 5 5 5 
25 26 29 18 18 18 28 27 16 16 16 16 16 16 16 16 16 16 16 8 3 4 5 5 5 5 5 5 5 6 3 4 5 5 5 5 5 5 5 1 34 1 34 8 3 7 34 34 34 34 
34 34 23 18 28 26 27 12 10 10 10 10 10 10 10 10 10 10 10 11 3 7 16 16 16 16 16 16 16 8 3 7 34 34 34 34 34 34 34 34 34 1 34 8 3 9 10 10 1 34 
34 34 25 26 27 34 34 8 3 3 3 3 3 3 3 3 3 3 3 3 3 7 16 34 34 34 34 34 16 8 3 7 34 1 1 1 1 1 1 1 1 1 34 8 3 3 3 3 7 34 
34 34 34 34 34 34 34 8 3 4 5 5 6 3 4 5 5 5 5 6 3 7 16 16 16 16 16 16 16 8 3 7 34 34 34 34 34 34 34 34 34 34 34 1 5 5 6 3 7 34 
34 34 34 34 34 34 34 8 3 7 34 34 8 3 7 1 16 16 16 8 3 9 10 10 10 10 10 10 10 11 3 9 10 10 10 10 10 10 10 10 10 10 10 1 34 34 8 3 7 34 
10 10 10 10 10 10 10 11 3 7 34 34 8 3 7 1 33 33 16 8 3 3 3 3 3 3 3 3 3 3 3 3 3 3 3 3 3 3 3 3 3 3 3 7 34 34 8 3 7 34 
3 3 3 3 3 3 3 3 3 7 34 34 8 3 7 1 33 33 16 8 3 4 5 5 5 5 5 5 5 6 3 4 5 5 5 5 5 5 5 5 5 6 3 7 34 34 8 3 7 34 
5 5 5 5 5 5 5 5 5 15 34 34 8 3 7 1 33 33 16 8 3 7 34 34 34 34 34 34 34 8 3 7 33 33 33 33 33 33 33 33 33 8 3 7 34 34 8 3 7 34 
34 34 34 34 34 34 34 34 34 34 34 34 14 5 15 1 33 33 16 8 3 7 34 1 1 1 34 34 34 8 3 7 33 34 34 34 34 34 34 34 33 8 3 7 34 34 8 3 7 34 
34 34 34 34 34 34 20 21 21 21 21 21 21 21 21 21 21 22 16 8 3 7 34 1 1 1 10 10 10 11 3 7 33 34 34 34 34 34 34 34 33 8 3 7 34 34 8 3 7 34 
21 21 21 21 21 21 31 19 19 19 19 19 19 19 19 19 19 24 16 8 3 7 34 1 1 1 3 3 3 3 3 7 33 34 34 34 34 34 34 34 33 8 3 7 34 34 8 3 7 34 
19 19 19 19 19 19 19 19 19 19 19 19 19 19 19 19 19 30 22 8 3 7 34 1 1 1 5 5 5 6 3 7 33 33 33 33 33 33 33 33 33 8 3 7 34 34 8 3 7 34 
19 19 19 19 19 19 19 19 19 19 19 19 19 19 19 19 19 19 24 8 3 7 34 1 1 1 33 33 33 8 3 9 10 10 10 10 10 10 10 10 10 11 3 7 34 34 8 3 7 34 
19 19 19 19 19 19 19 19 19 19 19 19 19 19 19 19 19 19 24 8 3 7 1 1 1 1 1 1 33 8 3 3 3 3 3 3 3 3 3 3 3 3 3 7 34 34 8 3 7 34 
26 26 26 26 26 26 26 26 26 26 26 26 26 26 26 26 29 19 24 8 3 7 20 21 21 21 22 1 33 1 5 5 5 5 5 5 5 5 5 5 5 6 3 7 34 34 8 3 7 34 
10 10 11 3 7 1 1 1 8 3 7 34 1 1 1 1 25 26 27 8 3 7 23 19 19 19 24 1 33 33 33 33 33 33 33 33 33 33 33 33 33 8 3 7 34 34 8 3 7 34 
3 3 3 3 7 34 34 34 8 3 7 34 1 1 1 1 1 1 1 8 3 7 23 19 19 19 30 21 21 21 21 21 21 21 21 22 1 1 1 1 33 8 3 7 34 34 8 3 7 34 
5 5 6 3 9 10 10 10 11 3 7 34 34 34 34 34 34 34 34 8 3 7 25 29 19 19 19 19 19 19 19 19 19 19 19 24 1 1 1 1 33 8 3 7 1 1 8 3 7 20 
1 34 8 3 3 3 3 3 3 3 9 10 10 10 10 10 10 10 10 11 3 7 1 25 26 26 26 29 19 19 19 19 19 19 19 30 21 21 22 1 33 8 3 7 20 22 8 3 7 23 
1 34 8 3 4 5 5 5 6 3 3 3 3 3 3 3 3 3 3 3 3 7 1 1 1 1 1 25 26 26 26 26 26 29 19 19 19 19 30 21 22 8 3 7 23 24 8 3 7 23 
1 34 8 3 7 16 16 16 8 3 4 5 5 5 5 5 6 3 4 5 5 15 1 1 1 1 1 1 1 1 1 1 1 25 26 29 19 19 19 19 24 8 3 7 23 24 8 3 7 25 
1 34 8 3 7 16 34 16 8 3 7 16 16 16 16 16 8 3 7 16 1 1 1 1 1 1 1 1 1 1 1 1 1 1 1 25 26 29 19 19 24 8 3 7 25 27 8 3 7 16 
1 34 8 3 7 16 34 16 8 3 7 16 34 34 34 16 8 3 7 16 1 1 1 1 1 1 1 1 16 8 3 7 16 1 1 1 1 25 26 26 27 8 3 7 1 1 8 3 7 16 
1 34 8 3 7 16 34 16 8 3 7 16 34 34 34 16 8 3 7 16 16 16 16 16 16 16 16 16 16 8 3 7 16 16 16 16 16 16 16 16 16 8 3 7 1 1 8 3 7 16 
10 10 11 3 7 16 34 16 8 3 7 16 34 34 34 16 8 3 9 10 10 10 10 10 10 10 10 10 10 11 3 9 10 10 10 10 10 10 10 10 10 11 3 9 10 10 11 3 7 16 
3 3 3 3 7 16 34 16 8 3 7 16 34 34 34 16 8 3 3 3 3 3 3 3 3 3 3 3 3 3 3 3 3 3 3 3 3 3 3 3 3 3 3 3 3 3 3 3 7 16 
5 5 5 5 1 16 34 16 8 3 7 16 34 34 34 16 1 5 5 5 5 5 5 6 3 4 5 5 5 5 5 6 3 4 5 5 5 5 5 5 5 6 3 4 5 5 6 3 7 16 
16 16 16 16 16 16 34 16 8 3 7 16 34 34 34 16 16 16 16 16 16 16 16 8 3 7 16 16 16 16 16 8 3 7 16 16 16 16 16 16 16 8 3 7 16 16 8 3 7 16 
34 34 34 34 34 34 34 16 8 3 7 16 34 34 34 34 34 34 34 34 34 34 16 8 3 7 16 1 1 1 16 8 3 7 16 1 1 1 1 1 16 8 3 7 16 16 8 3 7 16 
16 16 16 16 16 16 16 16 8 3 7 16 16 16 16 16 16 16 16 16 16 16 16 8 3 7 16 16 16 16 16 8 3 7 16 16 16 16 16 16 16 8 3 7 16 16 8 3 7 16 
10 10 10 10 10 10 10 10 11 3 9 10 10 10 10 13 16 16 1 10 10 10 10 11 3 9 10 10 10 10 10 11 3 9 10 10 10 10 10 10 10 11 3 7 16 16 8 3 7 16 
3 3 3 3 3 3 3 3 3 3 3 3 3 3 3 7 16 16 1 3 3 3 3 3 3 3 3 3 3 3 3 3 3 3 3 3 3 3 3 3 3 3 3 7 16 16 1 1 1 16 
5 5 5 5 5 5 5 5 5 5 5 5 5 5 5 15 16 16 1 5 5 5 5 5 5 5 5 5 5 5 6 3 4 5 5 5 5 5 5 5 5 6 3 7 16 34 34 34 34 34 
16 16 16 16 16 16 16 16 16 16 16 16 16 16 16 16 16 16 16 16 16 16 16 16 16 16 16 16 16 16 8 3 7 16 16 16 16 16 16 16 16 8 3 7 16 34 16 16 16 16 
34 34 34 34 34 34 34 34 34 34 34 34 34 34 34 34 34 34 34 34 34 34 34 34 34 34 34 34 34 16 8 3 9 1 16 1 1 1 1 1 16 8 3 9 10 34 16 33 33 16 
34 34 34 34 34 34 34 34 34 34 34 34 34 34 34 34 34 34 34 34 34 34 34 34 34 34 34 34 34 16 8 3 3 1 16 1 1 1 1 1 16 8 3 3 3 3 3 35 33 16 
34 34 34 34 34 34 34 34 34 34 34 34 34 34 34 34 34 34 34 34 34 34 34 34 34 34 34 34 34 16 1 5 5 1 16 1 1 1 1 1 16 1 5 5 5 34 16 33 33 16 
